1111111111
1110000001
1C110111E1
100000C111
10111101P1
1000000101
101110F101
101C10F101
1C10000001
1111111111
