1111111111111111111111111111111111111111
1001110011100000001000011100111001110001
1001C000101000000010000101001C1001000001
10011100101000000010000101001C1001011001
1000C100101000000010000101001C10010E1001
10011100111001110011100111001C1001111001
1000000000000000000000000000000000000001
1C11111111111111111111111111111111111101
1010000000000000000000000000000000000001
1010111111111111111111111111111111111111
10101C00011000C11000C11000C1100001100001
101011110C0011000C11000C11000C1100C01101
1010111111111111111111111111111111111101
1010100000000000000000000000000000000001
1010101111111111111111111111111111111111
10101C0000C000000000000C0000000000000001
1010111111111111111111111111111111111101
101C000000000C00000000000C00000000000001
1011111111111111111111111111111111111111
1C000000000C00000000000C00000000000000P1
1111111111111111111111111111111111111111
