11111111111111111111
10000000000000000001
10111111111111111101
10000000000000000101
111111111111111101P1
10000000000000000111
100000000000000001E1
10000000000000000101
10000000000000000001
10000000000000000001
10000000000000000001
1000000000000000C001
10000000000000000001
10000000000000000001
10000000000000000001
10000000000000000001
10000000000000000001
10000000000000000001
10000000000000000001
10000000000000000001
10000000000000000001
11111111111111111111
